20 20
09 10 10 10 10 10 10 10 10 10 10 10 10 10 10 10 10 10 10 02
12 22 22 22 22 22 22 22 22 22 22 22 22 22 22 22 22 22 22 14
12 22 22 22 22 22 22 22 22 22 22 22 22 22 22 22 22 22 22 14
12 22 22 22 22 22 22 22 22 22 22 22 22 22 22 22 22 22 22 14
12 22 22 22 22 22 22 22 22 22 22 22 22 22 22 22 22 22 22 14
12 22 22 22 22 22 22 22 22 22 22 22 22 22 22 22 22 22 22 14
12 22 22 22 22 22 22 22 22 22 22 22 22 22 22 22 22 22 22 14
12 22 22 22 22 22 22 22 22 22 22 22 22 22 22 22 22 22 22 14
12 22 22 22 22 22 22 22 22 22 22 22 22 22 22 22 22 22 22 14
12 22 22 22 22 22 22 22 22 22 22 22 22 22 22 22 22 22 22 14
12 22 22 22 22 22 22 22 22 22 22 22 22 22 22 22 22 22 22 14
12 22 22 22 22 22 22 22 22 22 22 22 22 22 22 22 22 22 22 14
12 22 22 22 22 22 22 22 22 22 22 22 22 22 22 22 22 22 22 14
12 22 22 22 22 22 22 22 22 22 22 22 22 22 22 22 22 22 22 14
12 22 22 22 22 22 22 22 22 22 22 22 22 22 22 22 22 22 22 14
12 22 22 22 22 22 22 22 22 22 22 22 22 22 22 22 22 22 22 14
12 22 22 22 22 22 22 22 22 22 22 22 22 22 22 22 22 22 22 14
12 22 22 22 22 22 22 22 22 22 22 22 22 22 22 22 22 22 22 14
12 22 22 22 22 22 22 22 22 22 22 22 22 22 22 22 22 22 22 14
24 25 25 25 25 25 25 25 25 25 25 25 25 25 25 25 25 25 25 26